111111111111
1C00000000D1
1P011100C0D1
1000011E0001
111111111111