1111111111
1P00000E01
1001110001
1P0C011001
1111111111