1111111111
1P01000001
1001110001
100C011E01
1111111111