1111111111
1P00000001
1001110001
100C01101
1111111111