1111111111
1P00000E01
1001110001
1000011001
1111111111