1111111111
1000000001
1P01110001
100C011E01
1111111111